0 0 0 0 0 0 0 0 0 0 2 3 3 3 3 3
0 0 0 0 0 0 0 0 0 0 2 3 3 3 3 3
0 0 0 0 0 0 0 0 0 0 2 3 3 3 3 3
0 0 0 0 0 0 0 0 0 0 2 3 3 3 3 3
0 0 0 0 0 0 0 0 0 0 2 3 3 3 3 3
0 0 0 0 0 0 0 0 0 0 2 3 3 3 3 3
0 0 0 0 0 0 0 0 0 0 2 3 3 3 3 3
0 0 0 0 0 0 0 0 0 0 2 3 3 3 3 3
0 0 0 0 0 0 0 0 0 0 2 3 3 3 3 3
0 0 4 0 0 0 0 0 0 0 2 3 3 3 3 3
4 0 0 0 0 0 0 0 0 0 2 3 3 3 3 3
0 0 0 0 0 0 0 0 0 0 2 3 3 3 3 3